also remove image=同时移除镜像
Apply=应用
Are you sure=是否确定？
Cancel=取消
checking=正在检查
Completely REMOVE=全部**移除**
Console=控制台
day=天
days=天
disk image and definition=硬盘的镜像和定义
Disks=硬盘
Donate=捐赠
Done=完成
Edit=编辑
Execution error=执行错误
Force Stop=强制停止
Hibernate=休眠
Log for=此项目的日志
log=日志
Logs=日志
More Info=更多信息
No=否
OK=确定
Ok=确定
Pause=暂停
Proceed=继续
Project Page=项目页面
Read Me First=先阅读此处
Remove container=移除容器
Remove definition=移除定义
Remove image=移除镜像
Remove VM=移除虚拟机
Remove=移除
Restart=重新启动
Resume=继续
Start=启动
Stop=停止
Support=支持
Update container=更新容器
Update=更新
Updating all Containers=正在更新所有容器
Updating the container=正在更新此容器
VNC Remote=VNC 远程
WebUI=打开web图形界面
Yes, delete it=确定删除
Yes, update it=确定更新
Yes=是

; footer messages
Array Copying=硬盘阵列正在复制
Array Clearing=硬盘阵列正在清除
Array Starting=硬盘阵列正在启动
Array Stopping=硬盘阵列正在停止
Mounting disks=正在挂载硬盘
Retry unmounting user shares=重试卸载用户共享
Spinning up all drives=正在唤醒所有硬盘
Stale configuration=旧的配置
Starting services=正在启动服务
Stopping services=正在停止服务
Starting Recycle Bin=正在启动回收站
Stopping Recycle Bin=正在停止回收站
Sync filesystems=同步文件系统
Unmounting disks=正在卸载硬盘
Autostart disabled=自动启动已禁用
Missing encryption key=缺失加密密钥
Opening encrypted volumes=正在打开加密卷

; docker variables
Container Path=容器路径
Container Port=容器端口
Container Variable=容器变量
Container Label=容器标签
Container Device=容器设备
