A format is NEVER part of a data recovery or disk rebuild process and if done in such circumstances will normally lead to loss of all data on the disks being formatted=格式化**决不**会是数据恢复或硬盘阵列重建过程的一部分，如果在这种情况下进行格式化，通常会导致正在格式化的硬盘上的所有数据丢失
Aborted=已中止
Action=执行
Add Pool=添加池
Add Subpool=添加子池
Add ZFS Subpool=添加 ZFS 子池
Add=添加
After renaming the pool, check that your shares are assigned to the proper primary and secondary storage locations=重命名池后，请检查您的共享是否已分配到正确的主存储位置和辅助存储位置
After upgrading the volume may not be mountable in previous versions of Unraid=升级后，该卷可能无法在旧版本的 Unraid 系统中安装
All existing data on this device will be OVERWRITTEN when array is Started=阵列启动时，此设备上的所有现有数据将被覆盖
Array Devices=硬盘阵列设备
Array of %s devices=%s 设备的硬盘阵列
Array Operation=硬盘阵列操作
Attribute Name=属性名称
Attributes not available=属性不可用
Attributes=属性
auto=自动
Autotrim=自动 TRIM
Balance Status=负载均衡状态
Balance=负载均衡
Blacklisted=已列入黑名单
Boot Device=引导设备
Boot system in UEFI mode=UEFI 模式下的引导系统
btrfs balance status=BTRFS 文件系统负载均衡状态
btrfs check status=BTRFS 文件系统维护检查状态
btrfs filesystem usage=btrfs 文件系统使用情况
BTRFS operation is running=BTRFS 操作正在运行
btrfs scrub status=btrfs 清理状态
cache - Cache Devices=缓存-缓存设备
cache - L2ARC=缓存-L2ARC缓存
Canceled=已取消
Cannot contact key-server Please check your=无法联系密钥服务器，请检查您的
Capabilities not available=功能不可用
Capabilities=功能
Caution=**警告**
Check Filesystem Status=检查文件系统状态
Clear Stats=清除统计信息
Clearing in progress=正在清除中
Click on FLASH above this message=点击此条消息上方的 **FLASH** 按钮
Click to spin down device=点击以休眠设备
Click to spin up device=点击以唤醒设备
Comments=注释
complete=完成
Completed without error=已完成且无错误
completed=完成
Compression=压缩
Configuration valid=配置有效
Convert to raid0 mode=转换为 RAID 0 模式
Convert to raid1 mode=转换为 RAID 1 模式
Convert to raid10 mode=转换为 RAID 10 模式
Convert to raid1c3 mode=转换为 RAID 1C3 模式
Convert to raid1c4 mode=转换为 RAID 1C4 模式
Convert to raid5 mode see help=转换为 RAID 5 模式 **请参阅帮助**
Convert to raid6 mode see help=转换为 RAID 6 模式 **请参阅帮助**
Convert to single mode=转换为单一模式
Copying=正在复制
corrected=已校正
Create an empty file system on the disks shown as Unmountable discarding all data currently on the disks and update parity to reflect this=在显示为无法挂载的硬盘上创建空文件系统将丢弃当前硬盘上的所有数据，并更新奇偶校验以反映这一点
creating Flash backup zip file this may take several minutes=正在创建U盘(Flash)备份 zip 文件，这可能需要几分钟
Creating Flash backup=正在创建U盘(Flash)备份
Creation error=创建错误
Critical disk temperature threshold=临界硬盘温度阈值
Critical disk utilization threshold=临界硬盘利用率阈值
Critical NVME temperature threshold=NVMe 临界温度阈值
Critical SSD temperature threshold=SSD 临界温度阈值
Current operation %s on %s=当前操作 %s 在**%s**上进行
Current position=当前位置
Custom attributes use comma to separate numbers=使用逗号分隔自定义属性的数字
Data-Rebuild in progress=正在进行数据重建
Date of purchase=购买日期
Date=日期
dedup - Deduplication Tables=去重 - 去重表
Delete Pool=删除池
detected=检测到
Device contents invalid, in standby mode spun-down=设备内容无效，处于待机模式（已停转）
Device contents invalid=设备内容无效
Device encrypted and unlocked=设备已加密并已解锁
Device encrypted=设备已加密
Device is disabled=设备已禁用
Device is missing disabled=设备丢失（已禁用）
Device is part of a pool=该设备属于一个池
Device locked unknown error=该设备因未知错误而锁定
Device locked wrong encryption key=该设备因加密密钥错误而锁定
Device to be encrypted=要加密的设备
Dirty log detected=检测到脏日志
Disable Spin down delay to run a SMART extended self-test=禁用停转延迟后才可运行 S.M.A.R.T. 扩展自检
Disk in parity slot is not biggest=校验槽中的硬盘不是最大的
Disk Log Information=硬盘日志信息
Disk-Clear in progress=正在清理硬盘
Do not use reserved names=不要使用保留名称
Do not use user share names=不要使用用户共享名称
Download SMART report=下载 S.M.A.R.T. 报告
Dual parity valid requires ALL disks in their original slots=*双奇偶校验*要求**所有**硬盘都位于其原始插槽中
Elapsed time=经过的时间
Enable user share assignment=启用用户共享分配
encrypted=已加密
Encryption input=加密输入
Encryption status=加密状态
enter disk index and device name as applicable to your controller=输入适用于您的控制器的硬盘索引和设备名称
Enter new key=输入新密钥
Erase Device Content=擦除设备内容
Errors occurred - Check SMART report=发生错误 - 请检查 S.M.A.R.T. 报告
Estimated finish=预计完成需要的时间
Estimated speed=预计速度
Existing content is permanently lost=现有内容会永久丢失
Failed=失败
Feature=功能
File system corruption detected=检测到文件系统损坏
File system status=文件系统状态
File system type=文件系统类型
Finding %s error=查找：**%s**错误
Finding %s errors=查找：**%s**错误
Fix=修复
Flag=标志
Flash backup=U盘(Flash)备份
Flash device is set as public share=U盘(Flash)设备被设置为公共共享
Flash Device Settings=U盘(Flash)设备设置
Format Unmountable disks=格式化无法挂载的硬盘
Formatting=正在格式化
formatting=正在格式化
Free=可用空间
FS=文件系统
Global Configuration=全局配置
Hide=隐藏
Identification=标识
Identity is not available=识别不可用
Identity=身份
if checked, Start array but do not mount disks=如果选中，则启动硬盘阵列但不挂载硬盘
If this is a new array, move the largest disk into the parity slot=如果这是一个新的硬盘阵列, 请在 *奇偶校验* 插槽中分配容量最大的硬盘
If you are adding a new disk or replacing a disabled disk, try Parity-Swap=如果要添加新硬盘或替换被禁用的硬盘，请尝试奇偶校验交换 (Parity-Swap)
Incorrect confirmation=确认不正确
Ineligible to run this version of Unraid OS Please consider extending your=不符合运行此版本的 Unraid OS 的资格，请考虑延长您的
Information=信息
Insufficient free disk space available=可用硬盘空间不足
Interrupted=已中断
Invalid configuration=无效的配置
invalid device=无效设备
invalid devices=无效设备
Invalid expansion=无效的扩展
Invalid pool name=无效的池名称
Invalid, missing or expired=无效、丢失或过期
is only available when array is Started in Maintenance mode=仅当阵列在**维护模式**下启动时才可用
is only available when array is Started=仅在阵列启动时可用
Keyfile=密钥文件
Last check completed on %s=上次检查完成时间为**%s**
Last check incomplete on %s=上次检查未完成日期为**%s**
Last checked on %s=上次检查时间为**%s**
Last SMART test result=上次 S.M.A.R.T. 测试结果
logs - Separate Intent Log SLOG=日志 - 意图分隔记录（SLOG）
logs - ZFS Intent Log=日志 - ZFS意图日志
Maintenance mode=维护模式
Maintenance Mode=维护模式
Maintenance=维护
Manufacturing date=制造日期
Menu View=菜单视图
Minimum free space=最小可用空间
mirror=镜像
Missing Cache disk=缺少缓存硬盘
Missing disk=缺少硬盘
Missing key=缺少密钥
Missing pool disk=缺少池硬盘
Missing=缺少
Mounted=已挂载
Mover is running=Mover 正在运行
network settings=网络设置
New data disks detected=检测到新数据硬盘
next device=下一个设备
No array data disks have been assigned=未分配任何阵列数据硬盘
No array devices have been assigned=未分配任何阵列设备
No data disks=没有数据硬盘
no devices=没有设备
No devices=无设备
No file system corruption detected=未检测到文件系统损坏
No parity check history present=没有奇偶校验历史记录
No self-tests logged on this disk=此硬盘上没有记录任何自检
Not installed=未安装
Not present=不存在
OK=确定
Once copy completes, the array may be Started, to initiate Data-Rebuild of the disabled disk=复制完成后，可以启动阵列，以启动被禁用硬盘的数据重建。
operation=操作
Options see Help=选项（参见帮助）
Otherwise use the keyfile method for UTF8 input=否则，请对 UTF-8 输入使用**keyfile**方法
Parity disks content will be overwritten=*奇偶校验* 硬盘内容将被覆盖
Parity is already valid=奇偶校验已生效
Parity Operation History=奇偶校验操作历史
Parity operation is running=正在运行奇偶校验
Parity valid requires ALL disks to have their original content=*奇偶校验* 要求**所有**硬盘包含其原始内容
Parity-Check in progress=正在进行奇偶校验
ParityRead-Check History=奇偶校验/读取检查历史记录
Parity-Sync in progress=正在同步奇偶校验
Parity-SyncData-Rebuild in progress=正在进行奇偶校验-同步/数据-重建
Partition format=分区格式
Partition size=分区大小
Passed=直通
Passphrase=密码
Perform full balance=处理全部剩余空间
Permit UEFI boot mode=允许 UEFI 引导模式
Please change share SMB security=请更改 SMB 共享安全性
Please check your system settings to support UEFI boot mode=请检查您的系统设置以支持 UEFI 引导模式
Please try again=请重试
Pool Devices=池设备
Pool name already exists=池名称已存在
Pool of %s devices=该池包含 %s 个设备
Pool Status=存储池状态
Power=电源
Preclear in progress=正在进行预清除
previous device=前一个设备
Printable Characters Only=仅可打印字符
Proceed to start=继续开始
raid0=raid0
raid1=raid1
raid10=raid10
raid1c3=raid1c3
raid1c4=raid1c4
raid5=raid5
raid6=raid6
raidz=raidz
raidz2=raidz2
raidz3=raidz3
Raw Value=原始值
Raw View=原始视图
Read errors corrected=已修复读取错误
Read errors detected=检测到读取错误
Read-Check in progress=正在进行读取检查
Reading=读取中
Reboot in safe mode=以安全模式重启
Registration Key Manager=注册密钥管理器
registration key=注册密钥
ReiserFS is deprecated, please use another file system=ReiserFS 已被弃用, 请使用其他文件系统
reiserfsck status=reiserfsck 状态
Rename Pool=重命名池
Renaming the pool will change the share storage allocations=重命名存储池将更改共享存储分配
Repair corrupted blocks=修复损坏的块
Replacement disk installed=已安装替换硬盘
Replacement disk is too small=替换硬盘太小
Retype passphrase=重新输入密码
Schedule=计划任务
Scrub Status=清理状态
Scrub=清理
See %s Settings=参阅 %s 设置
self-test in progress=正在进行自检
Self-Test=自检
Server boot mode=服务器引导模式
Set default boot menu=设置默认引导菜单
show passphrase=显示密码
Show=显示
single=单
Slots=插槽
SMART attribute notifications=S.M.A.R.T. 属性通知
SMART controller type=S.M.A.R.T. 控制器类型
SMART error log=S.M.A.R.T. 错误日志
SMART extended self-test=S.M.A.R.T. 扩展自检
SMART health-check failed=S.M.A.R.T. 运行状态检查失败
SMART notification tolerance level=S.M.A.R.T. 通知等级
SMART notification value=S.M.A.R.T. 通知值
SMART self-test history=S.M.A.R.T. 自检历史记录
SMART self-test in progress=正在进行 S.M.A.R.T. 自检
SMART Settings=S.M.A.R.T. 设置
SMART short self-test=S.M.A.R.T. 简短自检
SMART status=S.M.A.R.T. 状态
spares - Hot Spares=备用 - 热备件
special - Metadata storage=特殊 - 元数据存储
special - Special Allocation Class=特殊 - 特殊分配类
Speed=速度
Spin down delay=延迟休眠
Spin Down=休眠
Spin Up=唤醒
Spinup groups=唤醒硬盘阵列
Started, array protected=已启动，硬盘阵列受保护
Started, array unprotected=已启动，硬盘阵列未受保护
Started, clearing=已启动，清理中
Started, formatting=已启动，格式化中
Starting, copying=已启动，复制中
Starting=正在启动
Stopping=正在停止
Sync errors corrected=同步错误已更正
Sync errors detected=检测到同步错误
Sync errors=同步错误
Sync=同步
Syslinux Configuration=Syslinux 配置
Syslinux configuration=Syslinux 配置
Temp=温度
The array will be immediately available, but unprotected since parity has not been assigned=硬盘阵列将立即可用，但**未受保护**，因为尚未分配 *奇偶校验* 硬盘
The array will be immediately available, but unprotected until Parity-Sync completes=硬盘阵列将立即可用，但**未受保护**，这种状态将延续到奇偶校验同步完成为止
The replacement disk must be as big or bigger than the original=替换硬盘的容量必须大于或等于原始硬盘
This is typically done when a new disk is added to the array to get it ready for files to be written to it=当将新硬盘添加到阵列中以使其准备好将文件写入其中时，就可以完成此操作
This Unraid OS release has been withdrawn and may no longer be used Please=此 Unraid OS 版本已被撤回，并可能不再使用。请
This will ERASE ALL device content=这将**擦除**设备中的**所有**内容
This will ERASE content of ALL devices in the pool=这将**擦除**存储池设备中的**所有**内容
This will ERASE ALL device content=这将删除所有设备内容
This will ERASE content of ALL devices in the pool=这将删除池中所有设备的内容
This will reboot the system=这将重启系统
This will shutdown the system=这将关闭系统
This will stop the array=这将停止硬盘阵列
This will stop the running operation=这将停止正在运行的操作
Threshold=阈值
Title=标题
To confirm type %s=确认类型: %s
Toggle readswrites display=切换读写显示
Too many attached devices Please consider upgrading your=连接的设备过多，请考虑升级您的
Too many wrong andor missing disks=错误和/或缺失的硬盘太多
Total size=总大小
Unassign ALL devices to delete this pool=取消分配**所有**设备以删除此池
Unassigned Devices=未分配设备
Unavailable - disk must be spun up=不可用 - 硬盘必须唤醒
unavailable no parity-check entries logged=不可用。未记录奇偶校验条目
Unavailable=不可用
Unclean shutdown detected=检测到不正常关机
Unmountable disk present=存在无法挂载的硬盘
Unmountable disks present=存在无法挂载的硬盘
Unmountable Encrypted volume present=无法挂载：存在加密卷
Unmountable Missing encryption key=无法挂载：缺少加密密钥
Unmountable No file system=无法挂载：没有文件系统
Unmountable No pool uuid=无法挂载：没有池 UUID
Unmountable not btrfs pool=无法挂载：不是 btrfs 池
Unmountable Unsupported or no file system=无法挂载：不支持的文件系统或无文件系统
Unmountable Volume not encrypted=无法挂载：卷未加密
Unmounted=未挂载
Upgrade Pool=升级 池
Upgrading diskswapping parity=升级硬盘交换奇偶校验
Use ASCII characters from space to tilde=使用从空格到波形符的**ASCII**字符
Use Default=使用默认值
Use default=使用默认值
Use only lowercase with no special characters or leadingtrailing digits=仅使用小写字母，没有特殊字符或前导/尾随数字
use printable characters only=仅使用可打印字符
Used=已使用
Value=值
W=瓦特
WARNING canceling may leave the array unprotected=警告：取消操作可能会使阵列不受保护
Warning disk temperature threshold=警告硬盘温度阈值
Warning disk utilization threshold=警告硬盘利用率阈值
Warning NVME temperature threshold=NVMe 警告温度阈值
Warning SSD temperature threshold=SSD 警告温度阈值
WARNING=警告
Warranty period=保修期限
While there is some risk, if it is not possible to first mount the filesystem to clear the log, zeroing it is the only option to try and repair the filesystem, and in most cases it results in little or no data loss=虽然存在一定的风险，但如果无法首先挂载文件系统以清除日志，那么将其置零是尝试修复文件系统的唯一选择，并且在大多数情况下，这不会导致数据丢失或仅导致极少量的数据丢失。
will activate a clean system power down=将激活系统正常关机
will activate a clean system reset=将激活系统正常重启
will bring the array on-line and start Clearing new data disks=将使硬盘阵列联机并开始**清理**新数据硬盘
will bring the array on-line and start Data-Rebuild=将硬盘阵列联机并开始**数据重建**
will bring the array on-line and start Disk-Clear of new data disks=将硬盘阵列联机并开始**数据重建**
will bring the array on-line and start Parity-Check=将使硬盘阵列联机并开始**奇偶校验**
will bring the array on-line and start Parity-Sync andor Data-Rebuild=将使硬盘阵列联机并启动**奇偶校验同步**和/或**数据重建**
will bring the array on-line and start Parity-Sync=将使硬盘阵列联机并开始**奇偶校验同步**
will bring the array on-line=将使硬盘阵列联机
will copy the parity information to the new parity disk=将奇偶校验信息复制到新的奇偶校验硬盘
will create a file system in all Unmountable disks=将在所有不可挂载的硬盘中创建文件系统
will delete the encryption keyfile=将删除加密密钥文件
will disable the missing disk and then bring the array on-line Install a replacement disk as soon as possible=将禁用缺失的硬盘，然后使阵列联机。请尽快安装替换硬盘
will expand the file system of the data disk if possible then bring the array on-line and start Data-Rebuild=将扩展数据硬盘的文件系统；如果可能，则将阵列联机并开始数据重建
will immediately clear all disk statistics=将立即清除所有硬盘统计信息
will immediately invoke the Mover=将立即调用 Mover 程序
will immediately spin down all disks=将立即休眠所有硬盘
will immediately spin up all disks=将立即唤醒所有硬盘
will pause Data-Rebuild=将暂停数据重建
will pause Disk-Clear=将暂停硬盘清理
will pause Parity-Check=将暂停奇偶校验
will pause Parity-Sync=将暂停奇偶校验同步
will pause Read-Check=将暂停读取检查
will pause the Clearing=将暂停清除
will pause the Parity-Check=将暂停奇偶校验
will pause the Parity-SyncData-Rebuild=将暂停奇偶校验同步/数据重建
will pause the Read-Check=将暂停读取-检查
will record all disk information and bring the array on-line=将记录所有硬盘信息并使阵列联机
will record all disk information, bring the array on-line, and start Parity-Sync=将记录所有硬盘信息，使阵列联机并启动奇偶校验-同步
will remove the missing cache disk and then bring the array on-line=将移除缺失的缓存硬盘，然后使阵列联机
will remove the missing pool disk and then bring the array on-line=将移除缺失的池硬盘然后使阵列在线
will resume Data-Rebuild=将恢复数据重建
will resume Disk-Clear=将恢复硬盘清除
will resume Parity-Check=将恢复奇偶校验
will resume Parity-Sync=将恢复奇偶校验同步
will resume Read-Check=将恢复读取检查
will resume the paused Clearing=将恢复暂停的清理
will resume the paused Parity-Check=将恢复暂停的奇偶校验
will resume the paused Parity-SyncData-Rebuild=将恢复暂停的奇偶校验同步/数据重建
will resume the paused Read-Check=将恢复暂停的读取-检查
will start Clearing new data disks=将启动**清理**新数据盘
will start Data-Rebuild=将启动**数据重建**
will start Disk-Clear of new data disks=将要开始新数据盘的**硬盘清理**
will start Parity-Check=将启动**奇偶校验**
will start Parity-Sync andor Data-Rebuild=将启动**奇偶校验同步**和/或**数据重建**
will start Parity-Sync=将启动**奇偶校验同步**
will start Read-Check of all array disks=将开始对阵列中所有硬盘进行**读取检查**
will stop Clearing=将停止清理
will stop Data-Rebuild=将停止数据重建
will stop Disk-Clear=将停止硬盘清理
will stop Parity-Check=将停止奇偶校验
will stop Parity-Sync=将停止奇偶校验同步
will stop Parity-SyncData-Rebuild=将停止奇偶校验同步/数据重建
will stop Read-Check=将停止读取检查
will stop the Parity-Check=将停止奇偶校验
will stop the Read-Check=将停止读取-检查
will take the array off-line=将离线(offline)硬盘阵列
Worst=最差
Write corrections to parity=将校正写入奇偶校验
Writes=写入
Wrong key=错误密钥
Wrong Pool State=存储池异常
xfs_repair status=xfs 修复状态
You may not add new disks and also remove existing disks=您不能添加新硬盘，也不能移除现有硬盘
your server=您的服务器
Zero Log=置零日志
zfs pool status=zfs 存储池状态
zfs=zfs

; Sleep plugin translations
Check this=检查此处
for more information=了解更多信息
Make sure your server supports S3 sleep=确保您的服务器支持 S3 级别的睡眠
Sleep will immediately put the server in sleep mode=**Sleep** 将立即使服务器进入睡眠模式
Sleeping=睡眠中
System in sleep mode=系统处于睡眠模式
This will put the system in sleep mode=这将使系统进入睡眠模式
wiki entry=Wiki 条目