%s ago=%s 之前
%s is out of range minimum 1 maximum 65535=%s 超出范围 最小值 1 最大值 65535
; Keep the original plugin name in settings
12 hours=12 小时制
24 hours=24 小时制
8023ad=802.3ad
a value of zero means no automatic closure=设置为 0 表示不自动关闭
Accumulation duration=累积时间
Accumulation frequency=累积频率
Activate=启用
Activated=已启用
Activating=正在启用
Active Directory Settings=活动目录设置
Active Directory=活动目录
active-backup=主动备份
AD account login=AD 帐户登录
AD account password=AD 帐户密码
AD domain name=AD 域名
AD initial group=AD 初始组
AD initial owner=AD 初始所有者
AD join status=AD 加入状态
AD short domain name=AD 短域名
Add Peer=添加 Peer
Add Route=添加路由
Add Tunnel=添加隧道
Add VLAN=添加 VLAN
Advanced=高级
Agent function=代理功能
Agents=代理
Alerts=严重
Allocation profile=分配配置详情
Allow Remote Access=允许远程访问
Allow=允许
Always On - Manual Port Forward=Always On - 手动配置端口转发
Always On - UPnP=Always On - UPnP
and, the first and last characters must be alphanumeric=并且第一个和最后一个字符必须为字母数字
and=和
Any=任何
APC UPS Daemon user manual=APC UPS 子程序用户手册
APCsmart=APCsmart
Apply to activate Docker after Array is Started=阵列启动后应用以激活Docker
Apply to activate VMs after Array is Started=阵列启动后应用以激活虚拟机
Applying=应用
Array must be Stopped to change=硬盘阵列必须**停止**后才能更改
Array status notification=硬盘阵列状态通知
Array status=硬盘阵列状态
Assignment error=分配错误
Attention=注意
Attribute=属性
Authentication method=身份验证方式
auto=自动
Auto-close=自动关闭
automatic=自动
Autostart=自动开启
Available notifications=可用通知
bad or missing key file=秘钥文件损坏或丢失
Balance schedule=均衡计划
balance-alb=平衡 - 自适应负载平衡
Balanced operation=平衡
balance-rr=平衡 - 轮循
balance-tlb=平衡 - 传输负载平衡
balance-xor=平衡 - 异或
Bar color - Text=条形颜色 - 文本
Bar color=条形颜色
Bar gray - Text=条形 (灰色) - 文本
Bar gray=条形 (灰色)
Basic=基础
Battery Charge=电池电量
Battery level to initiate shutdown=触发关机的电池电量阈值
Best performance=最佳性能
Best power efficiency=最佳能效
bfq=BFQ
Block group usage=块组使用情况
Bonding members of=绑定其成员
Bonding mode=绑定模式
boost=boost
Both Web Virt-Manager Remote Viewer=Web虚拟机管理和远程查看器
Both=两者
bottom-left=左下
bottom-right=右下
Boxed=盒装的
Bridging members of=桥接其成员
broadcast=广播
Browser=浏览器
btrfs filesystem show=btrfs 文件系统显示
btrfs scrub status=btrfs 清理状态
btrfs vDisk=btrfs 虚拟硬盘
Cache disk not enabled=缓存硬盘未启用
Cache Settings=缓存设置
Cannot provision cert that would overwrite your existing custom cert at=无法在此位置预配将覆盖现有自定义证书的证书
Cannot renew a custom cert at=无法续签自定义证书
Cannot renew cert until within 30 days of expiry=在到期后 30 天內无法更新证书
CA-signed certificate file=CA 签署的证书文件
Caution=注意
Celsius=摄氏度
center=居中
Certificate expiration=证书到期时间
Certificate issuer=证书发行者
Certificate not valid for=证书不可用于
Certificate subject=证书主题
Certificate URL=证书网址
Certificate will not renew unless you are signed in to Unraidnet=证书不会自动更新, 除非您登录到 Unraid.net
Change encryption key=更改加密密钥
Change power mode=更改电源模式
Changes=更改
Changing key failed for disks=更改硬盘密钥失败
Check cable=检查线缆
Check four times a day=每天检查四次
Check once a day=每天检查一次
Check once a month=每月检查一次
Check once a week=每周检查一次
Check twice a day=每天检查两次
Checking=正在检查
CIDR optional=CIDR 选项
Click here to see the Unraid Wiki for more information=单击此处查看 Unraid Wiki，以了解更多信息
Click to invoke the Mover=点击调用 Mover
Click to select PNG file=点击选择 PNG 文件
Click to Select=点击选择
Comma separated list of IPv4 and IPv6 IP addresses=用逗号分隔的 IPv4 和 IPv6 IP 地址列表
configure your router with a static route of=请配置您的路由器设置静态路由
configure your router with port forwarding of port=配置您的路由器以进行端口转发
configuring interface=配置界面
Confirm array stop command=确认阵列停止命令
Confirm reboot powerdown commands=确认重启和关机命令
Confirm sleep command=确认睡眠命令
Confirmations=确认信息
connect to any device on the VPN tunnel=连接到 VPN 隧道上的任何设备
connect to this server using IP address=使用 IP 地址连接到此服务器
Connected to Unraid Connect Cloud=已连接到 Unraid Connect 云
Console Options=控制台选项
Console Settings=控制台设置
Container=容器
Content=内容
Copy syslog to flash on shutdown=在关机时将系统日志复制到闪存
Correct file system errors=修正文件系统错误
CPU Isolation A reboot is required to apply changes=CPU 隔离：需要重启才能应用更改
CPU isolation is prohibited while system is running in SAFE MODE=当系统以**安全模式**运行时，禁止 CPU 隔离
CPU Isolation=CPU 隔离
CPU Pinning Docker=CPU 绑定 Docker
CPU Pinning VM=CPU 绑定虚拟机
CPU Pinning=CPU 绑定
CRAM-MD5=CRAM-MD5
Cumulative parity check=累积奇偶校验
Current date and time=当前日期和时间
Current listening interfaces=当前监听的网络接口
Current usage ratio=当前占用率
Custom attributes use comma to separate numbers=自定义属性使用逗号分隔数字
Custom banner=自定义横幅
Custom UPS cable=自定义 UPS 电缆
Custom=自定义
custom=自定义
D comma G dot=D （逗号）: G （点）
D comma G none=D （逗号）: G
D comma G space=D （逗号）: G （空格）
D dot G comma=D （点）: G（逗号）
D dot G none=D （点）: G
D dot G space=D （点）: G （空格）
Daily=每日
Data received=收到的数据
Data sent=发送的数据
Date and Time=日期和时间
Date format=日期格式
Day of the month=指定几号
Day of the week=指定周几
Day, D Month YYYY=星期，日月年
Day, DD.MM.YYYY=星期，日.月.年
Day, DD-MM-YYYY=星期，日-月-年
Day, MMDDYYYY=星期，月/日/年
Day, Month D, YYYY=星期，月 日, 年
Day, YYYY Month D=星期，年 月 日
Day, YYYY-MM-DD=星期，年-月-日
DD-MM-YYYY=日-月-年
Deactivate=停用
Deactivating=正在停用
Default appdata storage location=默认应用数据存储位置
Default critical disk temperature threshold=默认硬盘温度危险阈值
Default critical disk utilization threshold=默认硬盘利用率危险阈值
Default critical SSD temperature threshold=默认SSD温度危险阈值
Default file system for Array disks=硬盘阵列的默认文件系统
Default ISO storage path=默认 ISO 存储路径
Default network bridge=默认网桥
Default network source=默认网络配置
Default partition format=默认分区格式
Default SMART attribute notifications=默认 S.M.A.R.T. 属性通知
Default SMART controller type=默认 S.M.A.R.T. 控制器类型
Default SMART notification tolerance level=默认 S.M.A.R.T. 通知容错级别
Default SMART notification value=默认 S.M.A.R.T. 通知值
Default spin down delay=默认休眠延迟
Default VM storage path=默认虚拟机存储路径
Default warning disk temperature threshold=默认硬盘温度告警阈值
Default warning disk utilization threshold=默认硬盘利用率告警阈值
Default warning SSD temperature threshold=默认 SSD 温度告警阈值
Default Windows VirtIO driver ISO=默认 Windows VirtIO 驱动程序 ISO
Define a TLS certificate=指定 TLS 证书
Delete directory=删除目录
Delete Image File=删除镜像文件
Delete Peer=删除 Peer
Delete tunnel failed=删除隧道失败
Delete Tunnel=删除隧道
Delete vDisk file=删除虚拟硬盘文件
Delete VLAN=删除 VLAN
Deny=否
Desired MTU=所需 MTU
Detailed=详细
Device=设备
DHCP pool=DHCP 池
directory=目录
Disable AutostartStart option for VMs=禁用虚拟机的自动启动/启动选项
Disabled until connected to Unraid Connect Cloud=在连接到 Unraid Connect 云之前禁用
Disk Settings=硬盘设置
Display array totals=显示阵列总数
Display device name=显示设备名称
Display position=显示位置
Display Settings=显示设置
Display width=显示宽度
Display world-wide-name in device ID=在设备 ID 中显示通用名称
DNS Propagation is PENDING=DNS 传播正在**等待中**
DNS Rebinding Protection is ENABLED=已**开启** DNS 重绑定保护
DNS servers=DNS 服务器
docker containers on custom networks need static routing=自定义网络上的 Docker 容器需要静态路由
Docker custom network type=Docker 自定义网络类型
Docker data-root=Docker 默认存储路径
Docker directory=Docker 目录
Docker LOG maximum file size=Docker 日志最大文件大小
Docker LOG number of files=Docker 日志文件数
Docker LOG rotation=Docker 日志轮换
Docker only=仅限 Docker
Docker PID Limit=限制 Docker 进程数
Docker service=Docker 服务
Docker Stop Timeout=Docker 停止超时
Docker storage driver=Docker 存储驱动
Docker update notification=Docker 更新通知
Docker update=Docker 更新
Docker vDisk location=Docker 虚拟硬盘位置
Docker vDisk size=Docker 虚拟硬盘大小
Docker version=Docker 版本
Docker VMs=Docker + 虚拟机
Docker volume info=Docker 卷信息
Docker will be available after Array is Started=启动阵列后 Docker 可用
Docker=Docker
Dont show RDP option=不显示 RDP 选项 
download error=下载错误
Download Windows VirtIO driver ISO=下载 Windows VirtIO 驱动程序 ISO
Downloading=正在下载
Downstream=下游
Drag-n-drop a PNG file or click the image at the left=拖放 PNG 文件或单击左侧的图片
Dumb=简易
Duplicate port entered=输入了重复的端口
Dynamix color theme=Dynamix 颜色主题
eg=例如
Email recipients=电子邮件收件人
Email subject prefix=电子邮件主题前缀
Email=电子邮件
enable advanced settings view=启用高级设置视图
Enable auto start=启用自动启动
Enable bonding=启用绑定
Enable bridging=启用桥接
Enable container table readmore-js=启用容器页面的 readmore-js
Enable disk shares=启用硬盘共享
Enable Docker=启用 Docker
Enable NetBIOS=启用 NetBIOS
Enable NFS=启用 NFS
Enable NVME power monitoring=启用 NVMe 电源监控
Enable Outgoing Proxy=启用代理服务
Enable SMB Multi Channel=启用 SMB 多通道
Enable SMB=启用 SMB
Enable spinup groups=启用唤醒阵列
Enable user shares=启用用户共享
Enable VLANs=启用 VLAN
Enable VMs=启用虚拟机
Enable WSD=启用 WSD
encrypted=加密
Encryption Key Update=加密密钥更新
Enhanced macOS interoperability=增强 macOS 互操作性
ensure the peer network is different from=确保 peer 网络不同于
ensure the peer networks are different from=确保 peer 网络不同于
Ensure the primary network card eth0 has an IP address=确保首选网络eth0网卡有IP地址.
Enter existing passphrase=输入现有的密码短语
Enter route + gateway + metric=输入路由 + 网关 + 指标
Erase Pool=擦除 池
Ether=以太网
Ethernet Port=以太网端口
Event=事件
Every 2 hours=每 2 小时
Every 3 hours=每 3 小时
Every 4 hours=每 4 小时
Every 6 hours=每 6 小时
Every 8 hours=每 8 小时
Every day=每天
Every hour=每小时
Every month=每月
Every week=每周
exceeds Disk Shutdown=超过硬盘停机次数
Exclude listening interfaces=排除监听的接口
Excluded disks=排除的硬盘
Execution error=执行错误
Existing encryption key=现有的加密密钥
Fahrenheit=华氏度
Failed to open=打开失败
Failed to stop=停止失败
Failure to do so may result in your docker image suffering corruption at a later time=否则可能导致 Docker 镜像日后损坏
Fast=高频率
Favorites enabled=启用收藏功能
File system corruption fixed=已修复文件系统损坏
Finished=已完成
First day=第一天
First week=第一周
Flash backup=闪存备份
Font size=字体大小
Fourth week=第四周
FTP server=FTP 服务器
FTP Server=FTP 服务器
FTP users=FTP 用户
Full Balance recommended=建议进行全面平衡
gateway name or address=网关名称或地址
Gateway=网关
Generate Key=生成密钥
Generate Keypair=生成密钥对
Global Share Settings=全局共享设置
Global SMART Settings=全局 S.M.A.R.T. 设置
GRUB Configuration=GRUB 配置
Hardware=硬件
Header custom background color=标题自定义背景颜色
Header custom meta text color=标题自定义元文本颜色
Header custom secondary text color=标题自定义次要文本颜色
Header custom text color=标题自定义文本颜色
Header menu=标题菜单
Header show description=标题显示描述
HHMM=时：分
Hibernate VMs=休眠虚拟机
Hidden share names are not allowed=不允许隐藏共享名称
Hide dot files=隐藏 (**.**) 文件
Host access to custom networks=自定义主机访问网络
Hostname from DNS reverse lookup=主机名（通过 DNS 反向查找获取）
Hostname from syslog message=主机名（通过系统日志中获取）
hosts=主机
Hourly=每小时
HTML color code of 3 or 6 hexadecimal digits=三或六位十六进制数字的 HTML 颜色代码
HTTP port=HTTP 端口
httpIPport or httphostport=http://IP:port 或 http://host:port
HTTPS port=HTTPS 端口
Huge=巨大
Identification=标识
IEEE 8023=IEEE 802.3
if you have trouble logging in, close all other tabs pointing to this server and clear your browsers cache=如果您在登录过程中遇到问题, 请关闭指向该服务器的其他网页然后清除浏览器的缓存.
Import Tunnel=导入隧道
Importance=重要
In most cases, this should be your public WAN IPv4 instead=最常见的情况是, 这里应该是您公网 IPv4 地址, 而不是
In most cases, this should be your public WAN IPv4=最常见的情况是, 这里应该是您公网 IPv4 地址
In most cases, this should be your public WAN IPv6 instead=最常见的情况是, 这里应该是您公网 IPv6 地址, 而不是
In most cases, this should be your public WAN IPv6=最常见的情况是, 这里应该是您公网 IPv6 地址
inactive=不活跃
Include listening interfaces=包含监听的接口
Included disks=包含的硬盘
Incorrect existing key=现有密钥错误
Input a IPv4 address=输入 IPv4 地址
Input a IPv6 address=输入 IPv6 地址
Input a MAC address=输入 MAC 地址
Input a NTP server name, NTP pool name or IP address=输入 NTP 服务器名称、 NTP 池名称或 IP 地址
Input the correct date and time manually=手动输入正确的日期和时间
Interface description=接口说明
Interface Extra=额外接口
Interface Rules=接口规则
Invalid data=无效数据
Invalid email address=无效的电子邮件地址
Invalid IPv4 gateway=无效的 IPv4 网关
Invalid IPv4 range=无效的 IPv4 范围
Invalid IPv4 subnet=无效的 IPv4 子网
Invalid IPv6 gateway=无效的 IPv6 网关
Invalid IPv6 range=无效的 IPv6 范围
Invalid IPv6 subnet=无效的 IPv6 子网
Invalid pool address=无效 池 地址
Invalid subnet size=无效子网大小
IP address or FQDN=IP 地址或 FQDN
IP Address=IP 地址
IPv4 address A.B.C.D=IPv4 地址 A.B.C.D
IPv4 address assignment=IPv4 地址分配
IPv4 address=IPv4 地址
IPv4 custom network on interface=网络接口上自定义 IPv4 网络
IPv4 default gateway=IPv4 默认网关
IPv4 DNS server assignment=IPv4 DNS 服务器分配
IPv4 DNS server=IPv4 DNS 服务器
IPv4 IPv6=IPv4 IPv6
IPv4 network=IPv4 网络
IPv4 only=仅 IPv4
IPv4nn or IPv6nn route=IPv4/nn 或 IPv6/nn 路由
IPv6 address assignment=IPv6 地址分配
IPv6 address nnnnxxxxyyyy=IPv6 地址 nnnn:xxxx::yyyy
IPv6 address=IPv6 地址
IPv6 custom network on interface=网络接口上自定义 IPv6 网络
IPv6 default gateway=IPv6 默认网关
IPv6 DNS server assignment=IPv6 DNS 服务器分配
IPv6 DNS server=IPv6 DNS 服务器
IPv6 network=IPv6 网络
IPv6 only=仅 IPv6
IPv6 privacy extensions=IPv6 隐私扩展
ipvlan=ip vlan
is a self-signed certificate, ignore the browsers warning and proceed to the GUI=是自签名证书, 忽略浏览器的安全性警告然后继续打开图形用户界面
is a self-signed certificate, ignore the browsers warning when using this certificate=是自签名证书, 使用该证书时请忽略浏览器的安全性警告
is down=已关闭
is not in the=不在里面
is only available when the filesyestem is mounted=仅在文件系统挂载时可用
Isolated CPUs=已隔离 CPU
Isolation=隔离
Join=加入
Key successfully changed=密钥成功更改
Key=键
Keyfile=密钥文件
kyber=kyber
LAN hub spoke access=局域网中心与辐射式访问
LAN to LAN access=点对点局域网
Language update notification=语言更新通知
Language update=语言更新
Language=语言
Large=大
Last day=前一天
Last handshake=最后一次握手
Last week=上周
LE Cert Provisioned successfully=已成功提供预配 LE 证书
Leave=离开
Libvirt Log=Libvirt 日志
Libvirt storage location=Libvirt 存储位置
Libvirt vdisk size=Libvirt 虚拟硬盘大小
Libvirt version=Libvirt 版本
Libvirt volume info=Libvirt 卷信息
License key required=需要许可证密钥
List of peers=Peers 列表
List of VLANs contains duplicate VLAN numbers=VLAN 列表中包含重复 VLAN 编号
Listing height=清单高度
Loading=正在加载
Local access URLs=本地访问网络地址
Local endpoint=本地端口
Local gateway uses UPnP=本地网关使用 UPnP
Local keyboard layout=本地键盘布局
Local master=本地主节点
Local name=本地名称
Local private key=本地私钥
Local public key=本地公钥
Local screen blank time=本地屏幕空白时间
Local server configuration=本地服务器配置
Local server uses NAT=本地服务器使用网络地址转换(NAT)
Local syslog folder=本地系统日志文件夹
Local syslog maximum file size=本地系统日志最大文件大小
Local syslog number of files=本地系统日志文件数
Local syslog port=本地系统日志端口
Local syslog rotation=本地系统日志轮换
Local syslog server=本地系统日志服务器
Local TLD=本地顶级域名
Local tunnel address IPv6=本地隧道的 IPv6 地址
Local tunnel address=本地隧道地址
Local tunnel firewall=本地隧道防火墙
Local tunnel network pool IPv6=本地隧道网络池的 IPv6 地址
Local tunnel network pool=本地隧道网络池
Lost communication=通信中断
Low on battery=电池电量低
MAC address mismatch=MAC 地址不匹配
MAC address=MAC 地址
macvlan=mac vlan
Mail server port=电子邮件服务器端口
Mail server=电子邮件服务器
Make sure you understand what you are doing before enabling=在启用之前, 请确保了解自己在做什么
Manage password=管理密码
Manage=管理
Management Access=管理权限
Management Interface=管理接口
mandatory=强制
Manual=手动
Max Server Protocol Version=最新服务器协议版本
Medium=中频率
member of=的成员
Metric=指标
Mirror syslog to flash=将系统日志镜像到闪存
Misconfiguration can cause problems=配置错误可能会导致问题
Missing new key=缺少新密钥
Missing subnet size=缺少子网大小
MM-DD-YYYY=月-日-年
ModBus=ModBus
Modify with caution unable to validate path until Array is Started=谨慎修改: 硬盘阵列启动前无法验证路径
Month of the year=指定几月
Monthly=每月
Move now=立即启动迁移
Mover is running=Mover 正在运行
Mover logging=Mover 日志
Mover schedule=Mover 计划
Mover Settings=Mover 设置
mq-deadline=mq-deadline
MTU size=MTU 大小
Multicast=多点广播
Multi-function=多功能
Must be signed in to Unraidnet to provision cert=必须登录到 Unraidnet 才能提供证书
name or ip address=名称或 IP 地址
native=原始
Net=网
Network protocol=网络协议
Network Services=网络服务
Network Settings=网络设置
Never check=永不检查
Never send=永不发送
New date and time=新日期和时间
NFS=NFS
No Balance required=无需均衡
No battery detected=未检测到电池
No Cache device present=没有缓存设备
No Cache disk present=没有缓存硬盘
No change to report=没有更改
No CPU pinning available. Docker service must be started=没有可用的 CPU 绑定。必须先启动 Docker 服务
No CPU pinning available. VM service must be started=没有可用的 CPU 绑定。必须先启动虚拟机服务
no name=未命名
No Parity disk present=没有奇偶校验硬盘
No Reply=未回复
No suitable interfaces found for PTP=未找到适合PTP的接口
Nominal Power=标称功率
Non-tabbed=非选项卡式
Not activated=未激活
Not allowed to assign ZERO cores=不允许分配**零**个内核
Not compatible with NetBIOS=与 NetBIOS 不兼容
not configured=未配置
Not present=不存在
not received=未收到
not set=未设置
Not up-to-date=不是最新的
not used=未被使用的
Note=注释
Nothing to do=不执行任何操作
Notices=常规
Notification Agents=通知代理
Notification entity=通知对象
Notification Settings=通知设置
Notifications display=通知显示
NTP interval=NTP轮询间隔
NTP server=NTP 服务器
NTP=NTP
Number format=数字格式
Number of fuse File Descriptors=FUSE 文件描述符数量
Number of Threads=线程数
Number scaling=数字缩放
Obtaining DNSv4 server=获取 DNSv4 服务器
Obtaining DNSv6 server=获取 DNSv6 服务器
Obtaining IPv4 address=获取 IPv4 地址
Obtaining IPv4 gateway=获取 IPv4 网关
Obtaining IPv6 address=获取 IPv6 地址
Obtaining IPv6 gateway=获取 IPv6 网关
obtaining=获取中
On battery=正在使用电池
One or more paths do not exist=一个或多个路径不存在
Online=在线
Only alphanumeric characters=仅字母数字字符
Only modify if this is a new installation since this can lead to unwanted behaviour=否则可能引发意外情况，否则可能引发意外情况
Only PNG images are allowed=仅允许使用 PNG 格式的图片
Oops=糟糕
optional metric lowest is preferred, 0 is no default gateway=可选指标 (首选最低指标, 0 表示无默认网关)
optional metric lowest is preferred=可选指标 (首选最低指标)
Optional=可选
or=或
Outgoing Proxy Manager=代理服务设置
Outgoing Proxy=代理服务
Output Voltage=输出电压
overlay2=
Override UPS Capacity Watts=覆写 UPS 容量
Page view=页面视图
Parity Check=奇偶校验
Passphrase=密码短语
Password=密码
Path does not exist=路径不存在
PCIe ACS override=PCIe 访问控制服务覆盖
PCnet=PCnet
Peer allowed IPs=允许的对等节点IP
Peer DNS server=Peer DNS 服务器
Peer endpoint=对等端点
Peer name=Peer 名称
Peer preshared key=Peer 预分享秘钥
Peer private key=Peer 私钥
Peer public key=Peer 公钥
Peer tunnel address IPv6=Peer 隧道的 IPv6 地址
Peer tunnel address=Peer 隧道地址
Peer type of access=Peer 连接类型
Peer update required=Peer 需要更新
Perform TRIM Operation=执行 TRIM 操作
Permit exclusive shares=允许独占共享
Persistent Bash History=保留 Bash 历史记录
Persistent keepalive=保持连接
Ping=Ping
Placement of Users menu=用户菜单的位置
Please consider re-applying all configurations=请考虑重新应用所有配置
Please disable the VM function=请禁用虚拟机功能
Please do this NOW=请**立即**执行此操作
Please enter a valid gateway=请输入有效的网关
Please enter a valid range=请输入有效范围
Please enter a valid sending email address=请输入有效的电子邮件发送地址
Please enter a valid subnet=请输入有效的子网
Please match the requested format=请按照要求的格式提供
Please note that the flash backup is not encrypted at this time=注意, 此U盘备份未加密.
Please read the Help carefully=请仔细阅读帮助文档
Please Reboot system to make new rules active=请**重启**系统使得规则生效
Please Stop array to complete key installation=请停止硬盘阵列以完成秘钥的安装
Plugins update notification=插件更新通知
Plugins update=插件更新
Pool address is out of range=池地址超出范围
pool device stats=池 设备状态
Pool Device Status=池 设备状态
Pool Information=池 信息
Pool subnet size is not defined=未定义池子网大小
Pool subnet size is too large=池子网太大
Port %s is already in use by other services=%s 端口已被其他服务使用
Port %s is duplicated=%s 端口重复
Port %s is out of range minimum 1 maximum 65535=端口 %s 超出范围（最小 1 最大 65535）
Port already in use=端口已在使用中
Port Down=端口关闭
Port out of range=端口超出范围
Port Up=端口启动
Power Mode=电源模式
Preserve user defined networks=保留用户定义网络
Preset service=预设服务
Priority in header=标头优先级
Protocol=协议
Provision=预配
PTP clock=PTP 时间
PTP interface=PTP 接口
PTP mode=PTP 模式
PTP profile=PTP 配置文件
PTP server= PTP 服务器
PTP transport=PTP 传输方式
PTP=PTP
QEMU version=QEMU 版本
Questions See the documentation=有问题? 见<a href="https://wiki.unraid.net/Connect" target="_blank">文档</a>.
raidz1=RAID Z1
readmodifywrite=读取／修改／写入
recommended=推荐的
reconstruct write=重建写入
redirects to=重定向到
Refreshing=正在刷新
Registration key required=需要注册密钥
Reinitialize=重新初始化
Reinitializing=重新初始化中
Remark configure your router with port forwarding of port=备注: 请在路由器中设置端口转发
Remark to use the Dynamic - Manual Port Forward option for Remote Access please set Use SSLTLS to Strict in Management Access=备注: 要为远程访问使用 "Dynamic - 手动配置端口转发" 功能  请在访问控制中将"使用 SSL/TLS"设置到"严格".
Remark to use the UPnP options please set Use UPnP to Yes in Management Access=备注: 要使用 UPnP 选项，请在访问管理中将"使用 UPnP" 设置为 "是".
Remark=备注
Remote access to LAN=远程访问局域网
Remote access to server=远程访问服务器
Remote peer configuration=远程 Peer 设置
Remote syslog port=远程系统日志端口
Remote syslog server=远程系统日志服务器
Remote tunneled access=远程隧道访问
Remove pool=移除 池
Remove Pool=移除 池
Remove Windows VirtIO driver ISO=移除 Windows VirtIO 驱动程序 ISO
Replied=已回复
Required=规定
resolution=分辨率
Restore default image=恢复默认镜像
Retype new passphrase=重新输入新的密码短语
Route=路由
Routing Table=路由表
Rule=规则
Rules contain duplicate MAC address assignments=规则包含重复的 MAC 地址分配
Rules=规则
Runtime left to initiate shutdown=启动关机程序前的剩余运行时间
Runtime Left=剩余运行时间
Samba extra configuration=Samba 额外配置
Scheduled parity check=计划的奇偶校验
Scheduler=计划程序
Scrub schedule=清理时间表
Scrub Schedule=清理时间表
Scrub=清理
Second week=第二周
See Help for more details and workarounds=参阅帮助以获取更多详细信息和解决方法
see interface=查看界面
Select existing keyfile=选择现有的密钥文件
Select new keyfile=选择新的密钥文件
Select Proxy=选择代理
Self-signed certificate file=自签名的证书文件
Self-signed or user-provided certificate=自签名或用户提供的证书文件
Send crash information to Unraid developers=向 Unraid 开发者发送崩溃信息
Send every hour=每小时发送一次
Send every two hours=每两小时发送一次
Send four times a day=每天发送四次
Send once a day=每天发送一次
Send once a month=每月发送一次
Send once a week=每周发送一次
Send three times a day=每天发送三次
Send twice a day=每天发送两次
Sending email address=电子邮件发送地址
Server hub spoke access=服务器中心与辐射式访问
Server name=服务器名称
Server to server access=服务器到服务器访问
Server was unable to provision SSL certificate=服务器无法预配 SSL 证书
Set password=设置密码
Setting disabled in safe mode=在**安全模式**下已禁用设置
Settings menu=设置菜单
Show array utilization indicator=显示阵列利用率指示器
Show banner background color fade=显示横幅背景色渐变
Show banner=显示横幅
Show Dashboard apps=显示仪表板应用
show passphrase=显示密码短语
Show Peer Config=显示 Peer 配置
Show RDP menu option=显示 RDP 菜单选项
Show RDP option=显示 RDP 选项
Show VM Usage=显示虚拟机使用情况
Shutdown time-out=关机超时
Shutdown VMs=关闭虚拟机
shutdown=关机
Sign In to Unraidnet required=需要登录 Unraid.net
Simple=简单
slave=从机
Slow=低频率
Small=小
Smart=智能
SMB Extras=SMB 额外
SMB Settings=SMB 设置
SMB=SMB
SMTP Settings=SMTP 设置
SNMP=SNMP
Software=软件
Sorry, an error occurred in processing your SSL certificate=抱歉，处理 SSL 证书时出错
Sorry, an error occurred updating unraidnet DNS records=抱歉，更新 Unraid.net DNS 记录时出错
SSH port=SSH 端口
Start APC UPS daemon=启动 UPS 守护进程
Start page=起始页
Static=静态
Stop %s to make changes, see=停止 **%s** 以进行更改，参见
Stop corresponding docker containers=停止相应的docker容器
Store notifications to flash=将通知存储到U盘(flash)
stripe=
Subject=主题
Subnet=子网
subnet=子网
success=成功
Summarized=简洁
Switching the Storage Driver requires to delete and rebuild the Docker directory manually=切换存储驱动程序可能需要手动删除并重新构建Docker目录
Syslog Server=系统日志服务器
System goes down=系统将要关机
System identifier for logfile name=日志文件名中的系统标识符
System notifications=系统通知
System Setting=系统设置
System Settings=系统设置
Tabbed=选项卡式
Tailscale Lets Encrypt certificate=Tailscale 的 Let's Encrypt（CA） 证书
Tailscale URLs=Tailscale 网址
TCP=TCP
TELNET port=TELNET 端口
Temperature unit=温度单位
Template Authoring Mode=模板创作模式
Terminal font size=终端字体大小
Test running=测试运行
Test=测试
Text - Bar color=文本 - 条形（颜色）
Text - Bar gray=文本 - 条状（灰色）
Text=文本
The Local endpoint does not resolve to an IPv4 address=本地端点无法解析为IPv4地址
The Local endpoint does not resolve to an IPv6 address=本地端点无法解析为IPv6地址
The Local endpoint resolves to=本地端点解析为
The Local tunnel network pool cannot be in=此本地隧道网络池无法使用
The Local tunnel network pool IPv6 cannot be in=本地隧道网络池中的IPv6不能在
Third week=第三周
This is required to create VMs in KVM=在 KVM 中创建虚拟机时必需
this mode requires a network switch with proper setup and support=此模式需要具备适当设置和支持的网络交换机
this must be the only peer in the tunnel and sole active tunnel when in use=在使用时，这必须是隧道中唯一的对等端和唯一的活动隧道
This removes any connections running over this tunnel=这将删除通过此隧道运行的任何连接
This Unraid Server was unreachable from the outside=这个 Unraid 服务器从外面是无法访问的
This will unassign all devices from the pool but will NOT modify any device contents=这将从资源池中取消分配所有设备，但不会影响设备上的内容
Time format=时间格式
Time of the day=指定时间
Time on battery before shutdown=关机前的电池运行时间
Time state=时间状态
Time sync=时间同步
Time zone=时区
time-out=超时
Timestamp=时间戳
TLS certificate location=TLS 证书位置
To test your manual port forward, temporarily configure Allow Remote Access as Always On - Manual Port Forward=为了测试您手动配置的端口, 请临时将 '允许远程访问' 设置为 'Always On - 手动配置端口转发'
to=to
Toggle keys=切换秘钥
Toggle thread to containers=将线程切换到容器
Toggle view=切换视图
top-left=左上
top-right=右上
Trim Now=立即执行 TRIM
TRIM operation started=已开始 TRIM
TRIM schedule=TRIM 计划表
TRIM Settings=TRIM 设置
trim=TRIM
Tunable enable Direct IO=是否启用无缓存读写
Tunable enable NCQ=设置NCQ模式
Tunable fuse_remember=设置 fuse 缓存时间
Tunable md_num_stripes=设置 stripe 大小
Tunable md_queue_limit=设置队列请求限制
Tunable md_sync_limit=设置同步操作限制
Tunable md_write_method=设置写入操作模式
Tunable nr_requests=设置请求数量
Tunable poll_attributes=设置轮询间隔
Tunable scheduler=设置调度程序
Tunable support Hard Links=是否开启硬链接
Tunnel has running containers attached=隧道连接了正在运行的容器
tunnel is inactive=隧道处于非活动状态
Tunnel wg0=隧道 wg0
Turn off UPS after shutdown=关机后关闭 UPS
Type new passphrase=输入新的密码短语
UDP=UDP
UDPv4=UDP v4
UDPv6=UDP v6
Unable to register this Unraid Server=无法注册此 Unraid 服务器
Unassigned Devices=未分配的设备
unavailable=不可用
Unicast=单独广播
Unlimited=无限的
Unraid Connect=Unraid Connect
Unraid Lets Encrypt certificate=Unraid Let's Encrypt 证书
Unraid OS update notification=Unraid 操作系统更新通知
Unraid OS update=Unraid 操作系统更新
Unraidnet account status=Unraid.net 账户状态
Unraidnet Status=Unraid.net 状态
Update DNS=更新 DNS
updating=正在更新
Updating=正在更新
Upgrade Cert=升级证书
Upgrade ZFS Pool=升级 ZFS 池
UPnP forwarding not set=UPnP 转发未设置
UPnP state changed to=UPnP 状态变为
UPnP tunnel is inactive=UPnP 隧道未激活
Upon host shutdown=当主机关闭时
UPS cable=UPS 线缆
UPS Details=UPS 详细信息
UPS Load=UPS 负载
UPS Model=UPS 型号
UPS overloaded=UPS 过载
UPS Settings=UPS 设置
UPS Status=UPS 状态
UPS type=UPS 类型
URL=网址
USB=USB
Use DEFAULT setting when public NTP servers are defined=指定公共NTP服务器后，使用预设设置
Use image name dockerimg or docker-xfsimg or select a folder=使用镜像名称(docker.img 或者 docker-xfs.img)或者选择一个文件夹
Use NTP=使用 NTP
Use only letters A-Z, digits or space,dash,underscore=只能使用字母 A-Z、数字、空格和下划线
use printable characters only=只使用可打印字符
Use SSH=使用 SSH
Use SSLTLS=使用 SSL/TLS
Use STARTTLS=使用 TLS
Use TELNET=使用 TELNET
Use UPnP=使用 UPnP
Used Free columns=已使用/未使用列
User Preferences=用户首选项
User root=root 用户
User shares not enabled=用户共享功能未启用
User Utilities=用户程序
User=用户
Username=用户名
user-set=用户设置
uses=用户
value must be a number=值必须是数字
Value=值
Very large=非常大
Very small=非常小
VFIO allow unsafe interrupts=VFIO 允许不安全的中断
View libvirt log=查看 libvirt 日志
View Local Config=查看本地配置
View Peer Config=查看对等节点配置
View the Docs for more information=查看文档以获取更多信息
view=查看
Virt-Manager Remote Viewer=虚拟机管理器远程查看器
VLAN assignment mismatch=VLAN 分配不匹配
VLAN number=VLAN 编号
VM Manager=虚拟机管理器
VM manager=虚拟机管理器
VM Settings A reboot is required to apply changes=虚拟机设置 更改生效需要重新启动。
VM shutdown time-out=虚拟机关闭超时
VM Usage refresh timerseconds=虚拟机使用情况刷新时间间隔（秒）
VM=虚拟机
VMs only=仅虚拟机
VMs will be available after Array is Started=虚拟机将在启动阵列后可用
VPN Manager=VPN 管理器
VPN tunnel access for System=系统级的VPN隧道访问
VPN tunnel for docker containers only=只供 Docker 容器使用的 VPN 隧道
VPN tunneled access for docker=Docker 使用的 VPN 隧道
VPN tunneled access for system=系统使用的 VPN 隧道
VPN tunneled access=VPN 隧道访问
WAN Port=公网端口
Warnings=警告
Watts=瓦
Web interface=Web 界面
Week of the month=一月中的周
Weekly=每周
When running Unraid virtualized, there are no available power modes=运行虚拟化 Unraid 时，没有可用的电源模式
WireGuard Configuration=WireGuard 配置
WireGuard URLs=WireGuard 网址
Workgroup Settings=工作组设置
Workgroup=工作组
Write corrections to parity disk=将纠正信息写入奇偶校验盘
Wrong PTP server address=错误的 PTP 服务器地址
WSD options experimental=WSD 选项（实验性）
xfs vDisk=xfs 虚拟硬盘
Yearly=每年
You can not exclude this interface=您不能排除此接口
You must be signed in to Unraidnet in order to generate an Unraidnet SSL certificate=您必须登录到Unraid.net才能生成Unraid.net的SSL证书
Your existing Docker image file needs to be recreated due to an issue from an earlier beta of Unraid 6=由于 Unraid 6 早期测试版中一个问题, 需要重新创建现有容器(Docker)的镜像文件
Your hardware does not have Intel VT-x or AMD-V capability=您的硬件不具有 Intel VT-x 或 AMD-V 功能
Your Lets Encrypt SSL Certificate has been provisioned and a DNS record for local IP address=已设置您的 Let's Encrypt SSL 证书，及本地 IP 地址的 DNS 记录
Your Lets Encrypt SSL Certificate has been renewed=您的 Let's Encrypt SSL 证书已更新
Your local IP address %s has been updated for unraidnet=您本地 IP 地址 %s 已经在 unraid.net 中更新
Your router or DNS server has DNS rebinding protection enabled, preventing=您的路由器或 DNS 服务器已启用 DNS 重新绑定保护，以防止
Your server has been registered=您的服务器已经注册
Your Unraid Server is reachable from the internet=您的服务器已经可以从外部网络访问
YYYY-MM-DD=年-月-日
zfs pool information=zfs 池信息
zfs=zfs

; My Servers plugin
Account status=账户状态
Also delete cloud backup Restore from backup will be unavailable=同时删除云端备份. 将不能从备份恢复.
Always - Manual Port Forward=总是 - 手动端口转发
Always - UPnP=总是 - UPnP
Are you sure you want pause communication with your remote flash backup on unraidnet=您确定要暂停与 unraid.net 上远程闪存备份的通信吗？
Are you sure you want to delete your cloud backup Restore from backup will be unavailable=确定要删除云端备份嘛? 将不能从备份恢复.
Are you sure you want to delete your local flash backup=确定要删除本地U盘(flash)备份吗?
Are you sure you want to erase all change history in both local and unraidnet remote=您确定要删除本地和 unraid.net 远程中的所有更改历史记录吗？
Connected to My Servers Cloud=连接到我的云服务
Delete Cloud Backup=删除云端备份
Disabled until connected to My Servers Cloud=在连接到我的云端服务前不可用
Disabled until you have signed in=在登录前不可用
Disabled until you Provision a myunraidnet SSL Cert=在您提供 myunraid.net SSL 证书前不可用
Disabled until you Provision an unraidnet SSL Cert and set SSL-TLS to Auto=在您配置 unraid.net SSL 证书并将 SSL-TLS 设置为 Auto 之前不可用
Disabled until you Provision an unraidnet SSL Cert=不可用，直到您提供 unraid.net SSL 证书
Disabled until your root user account is password-protected=在您的 root 用户帐户受密码保护之前不可用
Dynamic - Manual Port Forward=动态 - 手动端口转发
Dynamic - UPnP=动态 - UPnP
Dynamic Remote Access allows you to do stuff that someone else can explain=动态远程访问允许您做一些其他人可以解释的事情
Enable Transparent 2FA for Local Access=开启本地访问的透明二步验证
Enable Transparent 2FA for Remote Access=开启远程访问的透明二步验证
In order to activate Flash Backup there must be at least 1GB of free space on your flash drive=在启动本地U盘(flash)备份之前, 请保证有1GB以上的可用空间.
Local T2FA requires a myunraidnet certificate=本地访问的透明二步验证需要 *.myunraid.net 证书
Local T2FA requires Unraid 610 or higher and a myunraidnet certificate=本地访问的透明二步验证需要 Unraid 6.10 或更高系统版本, 以及 *.myunraid.net 证书
Local T2FA requires Unraid 610 or higher=本地访问的透明二步验证需要 Unraid 6.10 或更高系统版本
Local T2FA requires Use SSLTLS to be Auto and a myunraidnet certificate=本地访问的透明二步验证需要使用 SSL/TLS , 以及 *.myunraid.net 证书
Local T2FA requires Use SSLTLS to be Auto and Unraid 610 or higher=本地访问的透明二步验证要求使用 SSL/TLS , 以及 Unraid 6.10 或更高系统版本
Local T2FA requires Use SSLTLS to be Auto, Unraid 610 or higher, and a myunraidnet certificate=本地访问的透明二步验证要求使用 SSL/TLS 为自动，Unraid 6.10 或更高系统版本, 以及 *.myunraid.net 证书
Local T2FA requires Use SSLTLS to be Auto=本地访问的透明二步验证要求使用 SSL/TLS
More information=更多信息
port=端口
Remote T2FA requires a myunraidnet certificate=远程访问的透明二步验证需要 *.myunraid.net 证书
Remote T2FA requires Remote Access to be enabled and a myunraidnet certificate=远程访问的透明二步验证需要启用远程访问和 *.myunraid.net 证书
Remote T2FA requires Remote Access to be enabled and Unraid 610 or higher=远程访问的透明二步验证需要启用远程访问, 以及 Unraid 6.10 或更高系统版本。
Remote T2FA requires Remote Access to be enabled, Unraid 610 or higher, and a myunraidnet certificate=远程访问的透明二步验证需要启用远程访问, Unraid 6.10 或更高系统版本, 以及一个 *.myunraid.net 证书
Remote T2FA requires Remote Access to be enabled=远程访问的透明二步验证需要启用远程访问功能
Remote T2FA requires Unraid 610 or higher and a myunraidnet certificate=远程访问的透明二步验证需要 Unraid 6.10 或更高系统版本, 以及 *.myunraid.net 证书
Remote T2FA requires Unraid 610 or higher=远程访问的透明二步验证需要 Unraid 6.10 或更高系统版本
The Unraid server is unreachable from outside your network Be sure you have configured your router to forward port=Unraid 服务器无法通过公网访问. 请确定已在路由器中配置正确的端口转发
to the Unraid server at=连接到 Unraid 服务器, 通过
Transient errors in this log can be ignored unless you are having issues=如果您没有遇到问题, 则可以忽略此日志中偶尔出现的错误
Unraid API extra origins=Unraid API 的额外来源
View Flash Backup Error Log=查看U盘(flash)备份错误日志
