20 EHCI=2.0 (EHCI)
30 nec XHCI=3.0 (nec XHCI)
30 qemu XHCI=3.0 (qemu XHCI)
9p Mode=9p 模式
Advanced tuning options=高级优化设置
Allocation=分配
and if using graphics device passthrough it too needs UEFI=‌如果使用显卡直通，也需要UEFI支持
Are you sure=是否确定
Array must be started to view Virtual Machines=必须启动硬盘阵列才能查看虚拟机
Autostart=自动启动
Back=返回
Base Image=基础镜像
Block Devices=块设备
Boot Order=启动顺序
Boot order=启动顺序
Bus=总线
Capacity=容量
CD1 ISO Image=CD1 ISO镜像
CD2 ISO Image=CD2 ISO镜像
Change Icon=更改图标
Check free space=检查剩余空间
Cleanup=清理
Click and Select cdrom image to install operating system=选择光盘镜像以安装操作系统
Clock Offset=时钟偏差
Clocks Offset=时钟偏差
Clocks=时钟
Clone=克隆
Config Folder=配置文件夹
Copy Paste Domain XML Configuration Here=在此处复制粘贴域 XML 配置
CPU Mode=CPU 模式
CPUs=CPU
Create=创建
CreateModify Template=创建/修改模板
Creating=正在创建
DateTime=日期时间
define if migratable=定义是否可迁移
define Multifunctiion Support=定义多功能支持
define OS boot options=指定系统启动选项
define the amount memory=指定内存量
define the maximum amount of memory=指定最大内存量
define type of cpu presented to this vm=指定提供给此虚拟机的 CPU 类型
Description=描述
description of virtual machine=虚拟机描述
Discard=舍弃
Disk devices=硬盘设备
Disk devicesVolume=硬盘设备/卷
Disk IO=硬盘 I/O
Download Folder=下载文件夹
Download, Click and Select virtio drivers image=下载，并选择 VirtIO 驱动镜像
Downloading=正在下载
Edit VM after clone=克隆后编辑虚拟机
eg=例如
Eject CD Drive=弹出 CD 设备
Emulated=模拟
Enable USB boot=启用 USB 启动引导
Enter name=输入名字
ETA=预计时间
Evdev Device=Evdev 设备
Extracting=正在提取
Files being removed=文件移除中
Folder to save the LibreELEC image to= LibreELEC 镜像保存至
Folder to save the OpenELEC image to= OpenELEC 镜像保存至
Form View=表单视图
free=可用
FS Native Snapshot=FS 原始快照
grab options=抓取设置
Grab Toggle=抓取切换
Grab=抓取
Graphics Card=显卡
Graphics ROM BIOS=显卡 ROM BIOS
Graphics=图形
Guest agent not installed=客户端代理程序未安装
Guest CPU=客户端 CPU
Guest not running or guest agent not installed=客户端代理程序未安装或未运行
Guest not running=客户端未运行
Hide inline xml=隐藏内置 XML
Host CPU=主机 CPU
Host Passthrough=主机直通
Hyperv tweaks for Windows=针对 Windows Hyper-V 的调整
Hyper-V=Hyper-V
i440fx will work for most=‌i440fx 芯片组适用于大多数
Icon=图标
If name already exists it will be replaced=如果名称已存在，它将被替换
Initial=初始
Insert CD=插入CD
Insert=插入
Interfaces=接口
Invalid storage path=存储路径无效
Invalid VM to edit=尝试编辑的虚拟机（VM）不存在
IP Address=IP 地址
ISO Image=ISO 镜像
ISO storage path doesnt exist, please create the user share or empty folder first=ISO 存储路径不存在，你需要先创建共享用户或文件夹
ISO storage path doesnt exist=ISO 存储路径不存在
ISO storage path was empty=ISO 存储路径无效
keyboard for VM Console=虚拟机控制台键盘
keyboard for VNC=VNC 键盘
Leaving blank will use OS name=如果留空，将使用系统名称
LibreELEC Version=LibreELEC 版本
LibreELEC=LibreELEC
Libvirt Service failed to start=Libvirt 服务无法启动
Location of virtual machine files=虚拟机文件位置
Lock sortable items=锁定可排序的项目
Logical CPUs=逻辑 CPU
Machine=机器
Manual=手动
Max=最大值
MD5 verification failed, your download is incomplete or corrupted=MD5 验证失败，下载未完成或已损坏
Memory dump=内存转储
Memory inuseCurrentMaximum=已用内存 / 可用内存 / 最大内存
Migratable=可迁移的
Mode=模式
mount tag inside vm=虚拟机挂载标签
Multifunction=多功能
My Workstation=我的工作站
Name contains invalid characters or does not start with an alphanumberic for a ZFS storage locationOnly these special characters are valid Underscore _ Hyphen - Colon Period =名称包含无效字符，在ZFS存储位置中不能以字母数字开头，仅支持如下特殊字符：下划线(_)、短横线(-)、冒号(:)、点(.)
name of mount tag inside vm=虚拟机挂载标签名称
Name of virtual machine=虚拟机名称
Network Bridge=网络桥接
Network IO=网络 IO
Network MAC=网络 MAC
Network Model=网络模式
Network Source=网络资源
New VM=新虚拟机
No CD image inserted in to drive=未在设备中插入CD映像
No CD image inserted into drive=驱动器中未插入CD镜像
No GPU=无显卡
No Virtual Machines installed=未安装虚拟机
None available=无可用
Not enough free space, need at least=可用空间不足，至少需要
Not running=没有运行
Not set=未设置
OpenELEC Version=OpenELEC 版本
OpenELEC=OpenELEC
Optional=可选的
OS Install CDRom Bus=操作系统虚拟光盘总线类型
OS Install ISO=操作系统安装 ISO 镜像
Other PCI Devices=其他 PCI 设备
Other XML=其他 XML
Override Storage Location=覆盖存储位置
Overwrite=覆盖
OVMF requires a UEFI-compatable OS=OVMF 需要与 UEFI 兼容的操作系统
OVMF TPM=OVMF TPM
OVMF=OVMF
Parent=父项
password for VM Console=虚拟机控制台的密码
password for VNC=VNC 密码
path of Unraid share=Unraid 共享路径
path on Unraid share to save LibreELEC settings=用于保存 LibreELEC 设置的 Unraid 共享路径
path on Unraid share to save OpenELEC settings=用于保存 OpenELEC 设置的 Unraid 共享路径
Path to ROM BIOS file=ROM BIOS 文件路径
Pivot=支点
Please choose a folder the LibreELEC image will download to=请选择 LibreELEC 镜像将下载到的文件夹
Please choose a folder the OpenELEC image will download to=请选择 OpenELEC 镜像将下载到的文件夹
Pop-up Blocker is enabled Please add this site to your exception list=已开启弹窗拦截, 请将本站点添加到允许弹出窗口白名单
port for virtual console=虚拟控制台端口号
Prefix=前缀
Present=当前
Primary=主要
protocol for virtual console=虚拟控制台协议
Q35 for a newer machine model with PCIE=Q35 适用于较新的 PCIE 设备
QEMU Command Line=QEMU命令行
QEMU64=QEMU64
random mac, you can supply your own=随机 MAC，也可以自行设定
re-generate random mac address=重新生成随机 MAC 地址
Rename disabled, %s snapshots exists=重命名操作被禁用，已经存在 %s 个快照‌
Remove all files=移除所有文件
Remove Images=移除镜像
Remove LibreELEC image=移除 LibreELEC 镜像
Remove Meta=移除元数据
Remove OpenELEC image=移除 OpenELEC 镜像
Remove this LibreELEC file=移除此 LibreELEC 文件
Remove this OpenELEC file=移除此 OpenELEC 文件
Remove User Template=删除用户模板
Repeat=重复
Requires guest agent installed=需要安装客户端代理
Requires guest running=需要客户端运行
SeaBIOS will work for most=SeaBIOS 适用于大多数
SeaBIOS=SeaBIOS
Select ISO image=选择ISO镜像
Select ISO=选择ISO镜像
Select ISOs for CDROMs=为虚拟光盘选择 ISO 镜像
Select the BIOS=选择 BIOS
Select the LibreELEC version to use=选择要使用的 LibreELEC 版本
Select the machine model=选择机器型号
Select the OpenELEC version to use=选择要使用的 OpenELEC 版本
Select the USB Controller to emulate=选择要模拟的 USB 控制器
Select=选择
Separate sub-folder and image will be created based on Name=基于名称创建独立子文件夹和镜像
Serial=串口
Set discard option=设置舍弃选项
Set SDD flag=设置 SSD 标签
shares=共享
Show Inline XML=显示内置 XML
Snapshot Method=快照方式
Snapshot Name=快照名称
Snapshot=快照
Snapshots being removed=正在删除快照
Snapshots=快照
Some OSes wont support USB3=部分操作系统不支持 USB3.0
Sound Card=声卡
Specify a ISO storage path first=先指定一个 ISO 存储路径
SSD=SSD
Start All=全部启动
Start Cloned VM=启动克隆的虚拟机
Start VM after creation=创建后启动虚拟机
Stop All=全部停止
Template Name=模板名称
Tickpolicy=时钟策略
Timer Source=事件源
Toggle VM autostart=虚拟机自动启动切换
Top Image=置顶图像
Type Method=类型 (方式)
type of storage image=存储镜像类型
Unchecked will use QEMU External Snapshot=未选择将使用 QEMU 外部快照
Unknown action=未知操作
Unknown version=未知版本
Unlock sortable items=解锁可排序的项目
Unraid Mount tag=Unraid 挂载标签
Unraid Mount Tag=Unraid 挂载标签
Unraid Share Mode=Unraid 共享模式
Unraid Share=Unraid 共享
Unraid Source Path=Unraid 源路径
Updating=正在更新
USB Controller=USB 控制器
USB Devices=USB 设备
vDisk Bus=虚拟硬盘总线类型
vDisk Location=虚拟硬盘位置
vDisk Size=虚拟硬盘大小
vDisk Type=虚拟硬盘类型
vDisks vCDs=虚拟硬盘 / 虚拟光驱
vDisks=虚拟硬盘
Verifying=验证中
video for VM Console=虚拟机控制台的视频
video for VNC=VNC 视频
VirtIO Drivers CDRom Bus=包含 VirtIO 驱动程序的 CD-ROM 设备总线类型
VirtIO Drivers ISO=包含 VirtIO 驱动程序的 ISO 镜像
Virtiofs Mode=VirtIOFS 模式
Virtual Machines=虚拟机
Virtual=虚拟
VM Being Cloned=正在克隆的虚拟机
VM Being removed=正在移除的虚拟机
VM Clone=虚拟机克隆
VM Console AutoPort=自动选择虚拟控制台端口
VM Console enable Copypaste=启用虚拟控制台拷贝/粘贴
VM Console Keyboard=虚拟控制台键盘
VM Console Password=虚拟控制台密码
VM Console Port=虚拟控制台端口号
VM Console Protocol=虚拟控制台协议
VM Console Video Driver=虚拟控制台视频驱动
VM Console WS Port=虚拟机控制台 WS 端口
VM creation error=虚拟机创建错误
VM image deletion error=虚拟机镜像删除错误
VM Name=虚拟机名称
VM Usage Statisics=虚拟机使用情况统计
VNC Keyboard=VNC 键盘
VNC Password=VNC 密码
VNC Video Driver=VNC 视频驱动程序
VNC=VNC
Warning removing Snapshots can break the chain=警告：删除快照可能会破坏链条
Wasnt able to stop the process=无法停止该进程
Web UI to start from menu=从菜单启动web图形界面
Web UI to start=web图形界面启动
WebUI=web图形界面
Windows 7XP=Windows 7/XP
Windows 82012, newer Linux distros=Windows 8/2012，新 Linux 发行版
wsport for virtual console=虚拟控制台的WS端口
XML View=XML 视图
